 @@@@@@@@@@@@@@@@@@@@@@@@@@@@@@@@* ................................ @@@@@@@@@@@@@@@@@@@@@@@@@@@@@@@@
*@@ @@@@@@@@@@@@@@@@@@@@@@@@@@ @@@(@@@@@@@@@@@@@@@@@@@@@@@@@@@@@@@.@@(,@@@@@@@@@@@@@@@@@@@@@@@@@@ @@
@@//@#*@@@@@@@@@@@@@@@@@@@@ @@@@@@@@@@@@@@@@@@@@@@@@@@@@@@@@@@@@@.@@@@@@@.@@@@@@@@@@@@@@@@@@@@*@@ &@
@@@@@.%@ @@@@@@@@@@@@@@ &@@@@@@@@@ @@@@@@@@@@@@@@@@@@@@@@@@@@@@@@/#@@@@@@@@@(/@@@@@@@@@@@@@@.@/#@@@@
@@@@@@@@ @@.@@@@@@@@.@@@@@@@@@@.@@@@@@@@@@@@@@@@@@@@@@@@@@@@@@@@@@@@@ @@@@@@@@@@ @@@@@@@@.@%,@@@@@@@
@@@@@@@@@@@ @@ @/*@@@@@@@@@@ @@@@@@@@@@@@@@@@@@@@@@@@@@@@@@@@@@@@@@@@@@@ @@@@@@@@@@(/@,@@ @@@@@@@@@@
@@@@@@@@@@@@@@ @(&@@@@@@/#@@@@@@@@@@@@@@@@@@@@@@ @@# @@@@@@@@@@@@@@@@@@@@@@,&@@@@@@@*@ @@@@@@@@@@@@@
@@@@@@@@@@@@@@@@@ @.@ @@@@@@@@@@@@@@@@@@@@@@@@ @@@@@@@ @@@@@@@@@@@@@@@@@@@@@@@&,@.@ @@@@@@@@@@@@@@@@
@@@@@@@@@@@@@@@@@@@@ @(@@@@@@@@@@@@@@@@@@@@@@@ @@@@@@@&@@@@@@@@@@@@@@@@@@@@@@@(@ @@@@@@@@@@@@@@@@@@@
@@@@@@@@@@@@@@@@@@@@@@(% @@@@@@@@@@@@@@@@@@@@@@@@  /@@@@@@@@@@@@@@@@@@@@@@@@ ,%@@@@@@@@@ .@@@@@@@@@@
@@@@@@@/ & .@@@@@@@@@@@@@.@.@@@@@@@@@@@@@@@@@@@@@@@@@@@@@@@@@@@@@@@@@@@@@ &.@@@@@@@@@@@ @@%%& @@@@@@
@@@@@ @@@@@@@.@@@@@@@@@@@@@@.*@@@@@@@ .@@@@@@@@@@@@@@@@@@@@@@&.(@@@@@@&# @@@@@@@@@@@@@ @@@@@@ @@%@@@
@@@@@@@@@@@@@*,@@@@@@@@@@@@@@@@ (@@@@@@@@@@@@@@@@@@@@@@@@@@@@@@@@@@@  @@@@@@@@@@@@@@@ @@@@@@@@@ &@*@
@@@%@%@ @@@@ @@ @@@@@@@@@@@@@@@ @@@@@@@@@@@@@@@@@(/(@@@@@@@@@@@@@@@@@#@@@@@@@@@@@@@@*@@@@@@@@@@@*@%@
@@ @@@,.(@@@@ @@.@@@@@@@@@@@@@@ @@@@@@@@@@@ .@@@,@@@*@@@.(@@@@@@@@@@@#@@@@@@@@@@@@@/@@@@@@@@@@@@*@%@
@@#@@ @@@@@@@@ .@@@@@@@@@.. @@@ @@@@@@@@@ @@@ @@@@(@@@@.@@@.@@@@@@@@@#@@& #@@@@@@@@ @@@@@@@@@@@@*@%@
@@@@@.@@@@@@@@#@@*@@@@@@@* @/@@ @@@@@@@@(@@.@@@@@&,@@@@@@.@@ @@@@@@@@#@,@@@  @@@@@@ @@@@@@@@@@@@*@%@
@&@@@,@@@& .*@@@@.@@@@@ *.@%@*@ @@@@@@@@@@%@@@ @@@(@@@.@@@%@@@@@@@@@@#*@@@@ @@@@@@@ @@@@@@@@@@@@*@%@
@%@@@,@@@@@@@@@@@.@@@@@ @*@@@ @ @@@@@@@@@@&@@.@@@@(@@@@ @@@@@@@@@@@@@#/@@@@ @@@@@@@ @@@@@@@@@@@@*@%@
@&@@@,@@@@@@@@@@@.@@@@@ &,%#( @ @@@@@@@@@@@@@/@@@@(@@@@ @@@@@@@@@@@@@#/@@@@ @@@@@@@ @@@@@@@@@@@@*@%@
@&@@@,@@@@@@@@@@@.@@@@@ @*@@@ @ @@@@@@@@%%#@@*@@@@#@@@@ @@@@@@@@@@@@@#/@@@@ @@@@@@@ @@@@@@@@@@@@*@%@
@&@@@,@@@@@@@@@@@.@@@@@ @*@@@ @ @@@@@@@@@@&@@*@@@@(@@@@ @@@@@@@@@@@@@#(@@@@ @@@@@@@ @@@@@@@@@@@@*@%@
@%@@@,@@@@@@@@@%@.@@@@@ @. .@ @ @@@@@@@@@@&@@*@@@@(@@@@ @@@@@@@@@@@@@%(@@@@ @@@@@@@ @@@@@@@@@@@@*@%@
@%@@@ .,@@@@@@@@@.@@@@@ @*@@@ @ @@@@@@@@%%#@@*@@@@(@@@@ @@&&&@@@@@@@@%(#@@@ @@@@@@@  *@@@@@@@@@@*@%@
@%@@@,@@@@@@@@@@@.@@@@@  ,@@@ @ @@@@@@@///*//.//(/,*/// ((//(/&@@@@@@%(@@@@ @@@@@@@ @(@@@@@@@@@@*@%@
@%@@@,@@@@@@(.@@@.@@@@@ @*@.* @ @@@@@@.@@@@@@@@@@@@@@@@@@@@@@@.@@@@@@%(@@@@ @@@@@@@ @@@@@@@@@@@@*@%@
@%@@@,@.&@@@@@@@@.@@@@@ @*@@/ @ @@@@@@@@@@@@@@@@@@@@@@@@@@@@@@@@@@@@@&#@@@@ @@@@@@@ @@@@@@@@@@@@*@%@
@&*@@,@@@@@@@@@(@.@@@@@ @ @@ @/&@@%@@@@@/@@@@@@@@@@@@@@@@@@@@@@@@@@@@/#@@@@ @@@@@@@ @@@@@@@@@@@@*@%@
@&@@@,@@@@@ @@@@@.@@@@@ @ @@ @@@@*@@@@@&@@@@@@@@@@@@@@@@@@@@@@@@@@*@@@@@.@@ @@@@@@@ @@@@@@@@@@@@*@%@
@&@@@,@ @@@@@@@@@.@@@@@ @.@@@@@ @@@@@@@@@@@@@@@@@@@@@@@@@@@@@@@@@@@@ @@@@@  @@@@@@@ @@@@@@@@@@@@*@%@
@&@ &,@@@@@@@#(#  @@@@@ @@@@@@@@@@@@@@@@@@@@@@@@@@@@@@@@@@@@@@@@@@@@@@%@@@@@@ @@@@@ @@@@@@@@@@@@*@%@
@&@@@,@@@@/&@@@@@.@@ @@@@@@@ @@@@@@@@#@@@@@@@@@@@@@@@@@@@@@@@@@@@@@@@@@@@@@@@@@/&@@ @@@@@@@@@@@@*@&@
@&@@@,@,&@@@@@, .  @@@@@@@.@@@@@@@@@,@@@@@@@@@@@@@@@@@@@@@@@@@@@&@@@@@@@@.@@@@@@@@  @@@@@@@@@@@@*@&@
@&@@*,@@@@@@,@@##@@@@@@@&@@@@@@@@@@ @@@@@@@@@@@@@@@@@@@@@@@@@@@@@#@@@@@@@@@ @@@@@@@@ @@@@@@@@@@@*@&@
@&@@@,@@@ @@@ @@@@@@@@@ @@@@@@@@@@ @@@@@@@@@@@@@@@@@@@@@@@@@@@@@@@/@@@@@@@@@@ @@@@@@@@ @@@@@@@@@*@&@
@&@@@,%&@@@ @@@@@@@@@ @@@@@@@@@@@ @@@@@@@@@@@@@@@@@@@@@@@@@@@@@@@@@.@@@@@@@@@@@/@@@@@@@@@,@@@@@@*@&@
@&@@ @@@&*@@@@@@@@@%@@@@@@@@@@@@,@@@@@@@@@@@@@@@@@@@@@@@@@@@@@@@@@@@ @@@@@@@@@@@&@@@@@@@@@@ @@@@*@&@
@ @@@@ @@@@@@@@@@@/@@@@@@@@@@@@%@@@@@@@@@@@@@@@@@@@@@@@@@@@@@@@@@@@@@ @@@@@@@@@@@@ @@@@@@@@@@ @@*@&@
@&@@ @@@@@@@@@@@.@@@@@@@@@@@@@@@@@@@@@@@@@@@@@@@@@@@@@@@@@@@@@@@@@@@@@.@@@@@@@@@@@@@ @@@@@@@@@@#*@&@
@&.@@@@@@@@@@@,@@@@@@@@@@@@@@@(@@@@@@@@@@@@@@@@@@@@@@@@@@@@@@@@@@@@@@@@ @@@@@@@@@@@@@@ @@@@@@@@@@@ @