@@@@@@@@@@@@@@@@@@@@@@@@@@@@@@@@@@@@@@@@@@@@@@@@@@@@@@@@@@@@@@@@@@@@@@@@@@@@@@@@@@@@%@@@@@@@@@@@@@@@
@@@@@@@@@@@@@@@@@@@@@@@@@@@@@@@@@@@@@@@@@@@@@@@@@@@@@@@@@@@@@@@@@@@@@@@@@@@/@@@@@@@ @@@@@@@@@@@@@@@@
@@@@@@@@@@@@@@@@@@@@@@@@@@@@@@@@@@@@@@@@@@@@@@@@@@@@@@@@@@@@@@@@@@@@@@@@@@@@ @@@@@  @@@@@@/@@@@@@@@@
@@@@@@@@@@@@@@@@@@@@@@@@@@@@@@@@@@@@@@@@@@@@@@@@@@@@@@@@@@@@@@@@@@@@@@@@*@@@@  @@  @@@@  @@@@@@@@@@@
@@@@@@@@@@@@@@@@@@@@@@@@@@@@@@@@@@@@@@@@@@@@@@@@@@@@@@@@@@@@@@@@@@@@@@@@@@@  &        *@@@@@@@@@@@@@
@@@@@@@@@@@@@@@@@@@@@@@@@@@@@@@@@@@@@@@@@@@@@@@@@@@@@@@@@@@@@@@@@@@@@.      &*     @   ,@@@@@@@@@@@@
@@@@@@@@@@@@@@.@@@@@@@@@@@@@@@@@@@@@@@@@@@@@@@@@@@@@@@@@@@@@@@@@@@@@@@@@@%  & %@@@  @          (@@@@
@@@@@@@@@@@@@   &@@@@@@@@@@@@@@@@@@@@@@@@@@@@@@@@@@@@@@@@@@@@@@@@@@@@@@@@@(  @     @   @@@@@@@@@@@@@
@@@@@@@@@@@@     @@@@@@@@@@@@@@@@@@@@@@@@@@@@@@@@@@@@@@@@@@@@@@@@@@@@@@  @@@          @@@@%@@@@@@@@@
@@@@@@@@@@@@     /  @@@@@@@@@@@@@@@@@   .   .@@@@@.&@@@@@@@@@@@@@@@@@@@@@@@     *& @@  @@@@@@@@@@@@@
@@@@@@@@@@@@@      @@@@@@@@@@@@@@@@#    .(@@@@@@@@@@@@@@@@@@@@@@@@@@@@@@@@@@   &@@ @@@@%*@@@@@@@@@@@
@@@@@@@@@@@@@%    @@@@@@@@@@@@@@@@(     @ @@@@@@@@@@@@@@@@@@@@@@@@@@@@@@@@@@* &@@@@@@@@@@@@@@@@@@@@@
@@@@@@@@@@@@@@     @@@@@@@@@@@@@@#       @ @@@@@@@@@@@@@@@@@@@@@@@@@@@@@@@@@@(@@@@@@@@@@@@@@@@@@@@@@
@@@@@@@@@@@@( ,    /@@@@@@@@@@@@*           @@@@@@@@@@@@@@@@@@@@@@@@@@@@@@  @@@@@@@@@@@@@@@@@@@@@@@@
@@@@@@@@@@@@(  @@  @@@@@@@@@@@*  ,   -@-     @@@@@@@@@@@@@@@@@@@@@@@@@@@@# *@@@@@@@@@@@@@@@@@@@@@@@@
@@@@@@@@@@@ &  #   @ @@@@@@@@     (       @   @@@@@@@@@@@@@@@@@@@@@@@@@@@  @@@@@@@@@@@@@@@@@@@@@@@@@
@@@@@@@@@@@ @      @  *@@@@@@@@   @@  @@  @ @@@@@@@@@@@@@@@@@@@@@@@@@@@@  @@@@@@@@@@@@@@@@@@@@@@@@@@
@@@@@@@@@@@  @@@& @,   &          @(@@@@@@@  %@@@@@@@@@@@@@@@@@@@@@@@@@* #@@@@@@@@@@@@@@@@@@@@@@@@@@
@@@@@@@@@@@       % @   @        % @@@@@@@@ .     @@@@@@@@@@@@@@@@@@@@@  @@@@@@@@@@@@@@@@@@@@@@@@@@@
@@@@@@@@@@@      ,  @         *   @@@@@@@@*@        @@@@@@@@@@@@@@@@@@  @@@@@@@@@@@@@@@@@@@@@@@@@@@@
@@@@@@@@@@@@       @          @   . @@@@@@@          @@@@@@@@@@@@@@@@# @@@@@@@@@@@@@@@@@@@@@@@@@@@@@
@@@@@@@@@@@@      @            @*   .@@@@ *   @  @   */%@@@@@@@@@@@@   #@@@@@@@@@@@@@@@@@@@@@@@@@@@@
@@@@@@@@@@@@&           @       @%    @/@     @  ((       @@      @ @@@.@@@@@@@@@@@@@@@@@@@@@@@@@@@@
@@@@@@@@@@@@@          @@     @  @@     @    #@   ..                @@.&@@@@@@@@@@@@@@@@@@@@@@@@@@@@
@@@@@@@@@@@@@@        #@@     &   ,@%        @  %  @@      @  @   @/ @@@@@@@@@@@@@@@@@@@@@@@@@@@@@@@
@@@@@@@@@@@@@@       #@@@@     &@    @.     @  @@        @   @.  @@ ,@@@@@@@@@@@@@@@@@@@@@@@@@@@@@@@
@@@@@@@@@@@@@@      @@@@@@@      ,@     %     @@@@          @    @  @@@@@@@@@@@@@@@@@@@@@@@@@@@@@@@@
@@@@@@@@@@@@@@     @@@@@@@@    @&&@*   (,*   (@@@@@             @/ @@@@@@@@@@@@@@@@@@@@@@@@@@@@@@@@@
@@@@@@@@@@@@@@&   @@@@@@@@        *### @# @@    @@@@            @ %@@@@@@@@@@@@@@@@@@@@@@@@@@@@@@@@@
@@@@@@@@@@@@@@@@ @@@@@@@@                 @@@ . .@@@@.         @  @@@@@@@@@@@@@@@@@@@@@@@@@@@@@@@@@@
@@@@@@@@@@@@@@@@@@@@@@@@    @    @  ,*    @@@@   @@@@@@          @@@@@@@@@@@@@@@@@@@@@@@@@@@@@@@@@@@
@@@@@@@@@@@@@@@@@@@@@@@   @%   @@  ,@    .@@@@@@  @@@@@@,     % #@@@@@@@@@@@@@@@@@@@@@@@@@@@@@@@@@@@
@@@@@@@@@@@@@@@@@@@@@@        @&  #@      &@@. /@ .@@@@@@@   #  @@@@@@@@@@@@@@@@@@@@@@@@@@@@@@@@@@@@
@@@@@@@@@@@@@@@@@@@@@       @@   &@     , &@@      @@@@@@@@@   @@@@@@@@@@@@@@@@@@@@@@@@@@@@@@@@@@@@@
@@@@@@@@@@@@@@@@@@@@      ,@    @%         @@       @@@@@@@@  @@@@@@@@@@@@@@@@@@@@@@@@@@@@@@@@@@@@@@
@@@@@@@@@@@@@@@@@@@@    &@    /@(                   @@@@@@@@ *@@@@@@@@@@@@@@@@@@@@@@@@@@@@@@@@@@@@@@
@@@@@@@@@@@@@@@@@@&   @@     @@                      @@@@@@  @@@@@@@@@@@@@@@@@@@@@@@@@@@@@@@@@@@@@@@
@@@@@@@@@@@@@@@@@   @@     @@@           @@           @@@@  @@@@@@@@@@@@@@@@@@@@@@@@@@@@@@@@@@@@@@@@
@@@@@@@@@@@@@@@@  @       @@.            @@       @    @@& /@@@@@@@@@@@@@@@@@@@@@@@@@@@@@@@@@@@@@@@@
@@@@@@@@@@@@@@@         @@@              @@        @    @  @@@@@@@@@@@@@@@@@@@@@@@@@@@@@@@@@@@@@@@@@
@@@@@@@@@@@@@#         @@.   ./          &@         @  @  @@@@@@@@@@@@@@@@@@@@@@@@@@@@@@@@@@@@@@@@@@
@@@@@@@@@@@@#        @@@    @@            @          @,* @@@@@@@@@@@@@@@@@@@@@@@@@@@@@@@@@@@@@@@@@@@
@@@@@@@@@@@@       @@@     @@             @          .@  @@@@@@@@@@@@@@@@@@@@@@@@@@@@@@@@@@@@@@@@@@@
@@@@@@@@@@@      %@@      @@              @          @  @ .@@@@@@@@@@@@@@@@@@@@@@@@@@@@@@@@@@@@@@@@@
@@@@@@@@@@     %@%      @@@               @         @. @   @@@@@@@@@@@@@@@@@@@@@@@@@@@@@@@@@@@@@@@@@
@@@@@@@@@   %@         @@@                @         % .@   /@@@@@@@@@@@@@@@@@@@@@@@@@@@@@@@@@@@@@@@@
@@@@@/               /@@%                  &       @  @      #@@@@@@@@@@@@@@@@@@@@@@@@@@@@@@@@@@@@@@
@@*                                               @  @@         @@@@@@@@@@@@@@@@@@@@@@@@@@@@@@@@@@@@
@@@#              #@@@@@@,                *@@@@@@@@ (@@@@@@@@@@@@@@@@@@@@@@@@@@@@@@@@@@@@@@@@@@@@@@@